7zt5.pdb	[Errno 2] No such file or directory: '/mnt/larry/lilian/DATA/TCR3d_datasets/TCR_complexes_tfold_geochanged/7zt5.pdb'
4mng.pdb	[Errno 2] No such file or directory: '/mnt/larry/lilian/DATA/TCR3d_datasets/TCR_complexes_tfold_geochanged/4mng.pdb'
3ffc.pdb	[Errno 2] No such file or directory: '/mnt/larry/lilian/DATA/TCR3d_datasets/TCR_complexes_tfold_geochanged/3ffc.pdb'
4pjd.pdb	[Errno 2] No such file or directory: '/mnt/larry/lilian/DATA/TCR3d_datasets/TCR_complexes_tfold_geochanged/4pjd.pdb'
4pji.pdb	[Errno 2] No such file or directory: '/mnt/larry/lilian/DATA/TCR3d_datasets/TCR_complexes_tfold_geochanged/4pji.pdb'
8fjb.pdb	[Errno 2] No such file or directory: '/mnt/larry/lilian/DATA/TCR3d_datasets/TCR_complexes_tfold_geochanged/8fjb.pdb'
4pjf.pdb	[Errno 2] No such file or directory: '/mnt/larry/lilian/DATA/TCR3d_datasets/TCR_complexes_tfold_geochanged/4pjf.pdb'
6puh.pdb	[Errno 2] No such file or directory: '/mnt/larry/lilian/DATA/TCR3d_datasets/TCR_complexes_tfold_geochanged/6puh.pdb'
7zt3.pdb	[Errno 2] No such file or directory: '/mnt/larry/lilian/DATA/TCR3d_datasets/TCR_complexes_tfold_geochanged/7zt3.pdb'
8ek5.pdb	[Errno 2] No such file or directory: '/mnt/larry/lilian/DATA/TCR3d_datasets/TCR_complexes_tfold_geochanged/8ek5.pdb'
5u17.pdb	[Errno 2] No such file or directory: '/mnt/larry/lilian/DATA/TCR3d_datasets/TCR_complexes_tfold_geochanged/5u17.pdb'
6xqp.pdb	[Errno 2] No such file or directory: '/mnt/larry/lilian/DATA/TCR3d_datasets/TCR_complexes_tfold_geochanged/6xqp.pdb'
6bnl.pdb	[Errno 2] No such file or directory: '/mnt/larry/lilian/DATA/TCR3d_datasets/TCR_complexes_tfold_geochanged/6bnl.pdb'
6uk4.pdb	[Errno 2] No such file or directory: '/mnt/larry/lilian/DATA/TCR3d_datasets/TCR_complexes_tfold_geochanged/6uk4.pdb'
4lhu.pdb	[Errno 2] No such file or directory: '/mnt/larry/lilian/DATA/TCR3d_datasets/TCR_complexes_tfold_geochanged/4lhu.pdb'
2ol3.pdb	[Errno 2] No such file or directory: '/mnt/larry/lilian/DATA/TCR3d_datasets/TCR_complexes_tfold_geochanged/2ol3.pdb'
3qi9.pdb	[Errno 2] No such file or directory: '/mnt/larry/lilian/DATA/TCR3d_datasets/TCR_complexes_tfold_geochanged/3qi9.pdb'
8gom.pdb	[Errno 2] No such file or directory: '/mnt/larry/lilian/DATA/TCR3d_datasets/TCR_complexes_tfold_geochanged/8gom.pdb'
6pul.pdb	[Errno 2] No such file or directory: '/mnt/larry/lilian/DATA/TCR3d_datasets/TCR_complexes_tfold_geochanged/6pul.pdb'
9c42.pdb	[Errno 2] No such file or directory: '/mnt/larry/lilian/DATA/TCR3d_datasets/TCR_complexes_tfold_geochanged/9c42.pdb'
6pue.pdb	[Errno 2] No such file or directory: '/mnt/larry/lilian/DATA/TCR3d_datasets/TCR_complexes_tfold_geochanged/6pue.pdb'
7zt7.pdb	[Errno 2] No such file or directory: '/mnt/larry/lilian/DATA/TCR3d_datasets/TCR_complexes_tfold_geochanged/7zt7.pdb'
4ww2.pdb	[Errno 2] No such file or directory: '/mnt/larry/lilian/DATA/TCR3d_datasets/TCR_complexes_tfold_geochanged/4ww2.pdb'
4nqe.pdb	[Errno 2] No such file or directory: '/mnt/larry/lilian/DATA/TCR3d_datasets/TCR_complexes_tfold_geochanged/4nqe.pdb'
7lli.pdb	[Errno 2] No such file or directory: '/mnt/larry/lilian/DATA/TCR3d_datasets/TCR_complexes_tfold_geochanged/7lli.pdb'
7ryo.pdb	[Errno 2] No such file or directory: '/mnt/larry/lilian/DATA/TCR3d_datasets/TCR_complexes_tfold_geochanged/7ryo.pdb'
6puf.pdb	[Errno 2] No such file or directory: '/mnt/larry/lilian/DATA/TCR3d_datasets/TCR_complexes_tfold_geochanged/6puf.pdb'
3o8x.pdb	[Errno 2] No such file or directory: '/mnt/larry/lilian/DATA/TCR3d_datasets/TCR_complexes_tfold_geochanged/3o8x.pdb'
4lcc.pdb	[Errno 2] No such file or directory: '/mnt/larry/lilian/DATA/TCR3d_datasets/TCR_complexes_tfold_geochanged/4lcc.pdb'
6w9u.pdb	[Errno 2] No such file or directory: '/mnt/larry/lilian/DATA/TCR3d_datasets/TCR_complexes_tfold_geochanged/6w9u.pdb'
6uk2.pdb	[Errno 2] No such file or directory: '/mnt/larry/lilian/DATA/TCR3d_datasets/TCR_complexes_tfold_geochanged/6uk2.pdb'
7re7.pdb	[Errno 2] No such file or directory: '/mnt/larry/lilian/DATA/TCR3d_datasets/TCR_complexes_tfold_geochanged/7re7.pdb'
5yxn.pdb	[Errno 2] No such file or directory: '/mnt/larry/lilian/DATA/TCR3d_datasets/TCR_complexes_tfold_geochanged/5yxn.pdb'
5u1r.pdb	[Errno 2] No such file or directory: '/mnt/larry/lilian/DATA/TCR3d_datasets/TCR_complexes_tfold_geochanged/5u1r.pdb'
4pjb.pdb	[Errno 2] No such file or directory: '/mnt/larry/lilian/DATA/TCR3d_datasets/TCR_complexes_tfold_geochanged/4pjb.pdb'
8fja.pdb	[Errno 2] No such file or directory: '/mnt/larry/lilian/DATA/TCR3d_datasets/TCR_complexes_tfold_geochanged/8fja.pdb'
3rzc.pdb	[Errno 2] No such file or directory: '/mnt/larry/lilian/DATA/TCR3d_datasets/TCR_complexes_tfold_geochanged/3rzc.pdb'
3arf.pdb	[Errno 2] No such file or directory: '/mnt/larry/lilian/DATA/TCR3d_datasets/TCR_complexes_tfold_geochanged/3arf.pdb'
4l4v.pdb	[Errno 2] No such file or directory: '/mnt/larry/lilian/DATA/TCR3d_datasets/TCR_complexes_tfold_geochanged/4l4v.pdb'
7tr4.pdb	[Errno 2] No such file or directory: '/mnt/larry/lilian/DATA/TCR3d_datasets/TCR_complexes_tfold_geochanged/7tr4.pdb'
4pj8.pdb	[Errno 2] No such file or directory: '/mnt/larry/lilian/DATA/TCR3d_datasets/TCR_complexes_tfold_geochanged/4pj8.pdb'
3cvh.pdb	[Errno 2] No such file or directory: '/mnt/larry/lilian/DATA/TCR3d_datasets/TCR_complexes_tfold_geochanged/3cvh.pdb'
3vwk.pdb	[Errno 2] No such file or directory: '/mnt/larry/lilian/DATA/TCR3d_datasets/TCR_complexes_tfold_geochanged/3vwk.pdb'
6w9v.pdb	[Errno 2] No such file or directory: '/mnt/larry/lilian/DATA/TCR3d_datasets/TCR_complexes_tfold_geochanged/6w9v.pdb'
3arb.pdb	[Errno 2] No such file or directory: '/mnt/larry/lilian/DATA/TCR3d_datasets/TCR_complexes_tfold_geochanged/3arb.pdb'
4x6d.pdb	[Errno 2] No such file or directory: '/mnt/larry/lilian/DATA/TCR3d_datasets/TCR_complexes_tfold_geochanged/4x6d.pdb'
4lcw.pdb	[Errno 2] No such file or directory: '/mnt/larry/lilian/DATA/TCR3d_datasets/TCR_complexes_tfold_geochanged/4lcw.pdb'
3he7.pdb	[Errno 2] No such file or directory: '/mnt/larry/lilian/DATA/TCR3d_datasets/TCR_complexes_tfold_geochanged/3he7.pdb'
4pjg.pdb	[Errno 2] No such file or directory: '/mnt/larry/lilian/DATA/TCR3d_datasets/TCR_complexes_tfold_geochanged/4pjg.pdb'
4nqd.pdb	[Errno 2] No such file or directory: '/mnt/larry/lilian/DATA/TCR3d_datasets/TCR_complexes_tfold_geochanged/4nqd.pdb'
4y4k.pdb	[Errno 2] No such file or directory: '/mnt/larry/lilian/DATA/TCR3d_datasets/TCR_complexes_tfold_geochanged/4y4k.pdb'
5d7l.pdb	[Errno 2] No such file or directory: '/mnt/larry/lilian/DATA/TCR3d_datasets/TCR_complexes_tfold_geochanged/5d7l.pdb'
4y4f.pdb	[Errno 2] No such file or directory: '/mnt/larry/lilian/DATA/TCR3d_datasets/TCR_complexes_tfold_geochanged/4y4f.pdb'
6d7g.pdb	[Errno 2] No such file or directory: '/mnt/larry/lilian/DATA/TCR3d_datasets/TCR_complexes_tfold_geochanged/6d7g.pdb'
4nqc.pdb	[Errno 2] No such file or directory: '/mnt/larry/lilian/DATA/TCR3d_datasets/TCR_complexes_tfold_geochanged/4nqc.pdb'
1bd2.pdb	[Errno 2] No such file or directory: '/mnt/larry/lilian/DATA/TCR3d_datasets/TCR_complexes_tfold_geochanged/1bd2.pdb'
6c09.pdb	[Errno 2] No such file or directory: '/mnt/larry/lilian/DATA/TCR3d_datasets/TCR_complexes_tfold_geochanged/6c09.pdb'
6pvc.pdb	[Errno 2] No such file or directory: '/mnt/larry/lilian/DATA/TCR3d_datasets/TCR_complexes_tfold_geochanged/6pvc.pdb'
4pj7.pdb	[Errno 2] No such file or directory: '/mnt/larry/lilian/DATA/TCR3d_datasets/TCR_complexes_tfold_geochanged/4pj7.pdb'
5yxu.pdb	[Errno 2] No such file or directory: '/mnt/larry/lilian/DATA/TCR3d_datasets/TCR_complexes_tfold_geochanged/5yxu.pdb'
4y16.pdb	[Errno 2] No such file or directory: '/mnt/larry/lilian/DATA/TCR3d_datasets/TCR_complexes_tfold_geochanged/4y16.pdb'
4pj9.pdb	[Errno 2] No such file or directory: '/mnt/larry/lilian/DATA/TCR3d_datasets/TCR_complexes_tfold_geochanged/4pj9.pdb'
5u6q.pdb	[Errno 2] No such file or directory: '/mnt/larry/lilian/DATA/TCR3d_datasets/TCR_complexes_tfold_geochanged/5u6q.pdb'
3huj.pdb	[Errno 2] No such file or directory: '/mnt/larry/lilian/DATA/TCR3d_datasets/TCR_complexes_tfold_geochanged/3huj.pdb'
3o9w.pdb	[Errno 2] No such file or directory: '/mnt/larry/lilian/DATA/TCR3d_datasets/TCR_complexes_tfold_geochanged/3o9w.pdb'
3rtq.pdb	[Errno 2] No such file or directory: '/mnt/larry/lilian/DATA/TCR3d_datasets/TCR_complexes_tfold_geochanged/3rtq.pdb'
5u2v.pdb	[Errno 2] No such file or directory: '/mnt/larry/lilian/DATA/TCR3d_datasets/TCR_complexes_tfold_geochanged/5u2v.pdb'
3tvm.pdb	[Errno 2] No such file or directory: '/mnt/larry/lilian/DATA/TCR3d_datasets/TCR_complexes_tfold_geochanged/3tvm.pdb'
1nam.pdb	[Errno 2] No such file or directory: '/mnt/larry/lilian/DATA/TCR3d_datasets/TCR_complexes_tfold_geochanged/1nam.pdb'
6xc9.pdb	[Errno 2] No such file or directory: '/mnt/larry/lilian/DATA/TCR3d_datasets/TCR_complexes_tfold_geochanged/6xc9.pdb'
6xp6.pdb	[Errno 2] No such file or directory: '/mnt/larry/lilian/DATA/TCR3d_datasets/TCR_complexes_tfold_geochanged/6xp6.pdb'
4irs.pdb	[Errno 2] No such file or directory: '/mnt/larry/lilian/DATA/TCR3d_datasets/TCR_complexes_tfold_geochanged/4irs.pdb'
8f5a.pdb	[Errno 2] No such file or directory: '/mnt/larry/lilian/DATA/TCR3d_datasets/TCR_complexes_tfold_geochanged/8f5a.pdb'
5d5m.pdb	[Errno 2] No such file or directory: '/mnt/larry/lilian/DATA/TCR3d_datasets/TCR_complexes_tfold_geochanged/5d5m.pdb'
4g9f.pdb	[Errno 2] No such file or directory: '/mnt/larry/lilian/DATA/TCR3d_datasets/TCR_complexes_tfold_geochanged/4g9f.pdb'
4iiq.pdb	[Errno 2] No such file or directory: '/mnt/larry/lilian/DATA/TCR3d_datasets/TCR_complexes_tfold_geochanged/4iiq.pdb'
4qrr.pdb	[Errno 2] No such file or directory: '/mnt/larry/lilian/DATA/TCR3d_datasets/TCR_complexes_tfold_geochanged/4qrr.pdb'
4l4t.pdb	[Errno 2] No such file or directory: '/mnt/larry/lilian/DATA/TCR3d_datasets/TCR_complexes_tfold_geochanged/4l4t.pdb'
3sdd.pdb	[Errno 2] No such file or directory: '/mnt/larry/lilian/DATA/TCR3d_datasets/TCR_complexes_tfold_geochanged/3sdd.pdb'
8dv4.pdb	[Errno 2] No such file or directory: '/mnt/larry/lilian/DATA/TCR3d_datasets/TCR_complexes_tfold_geochanged/8dv4.pdb'
3sda.pdb	[Errno 2] No such file or directory: '/mnt/larry/lilian/DATA/TCR3d_datasets/TCR_complexes_tfold_geochanged/3sda.pdb'
5jhd.pdb	[Errno 2] No such file or directory: '/mnt/larry/lilian/DATA/TCR3d_datasets/TCR_complexes_tfold_geochanged/5jhd.pdb'
4ei5.pdb	[Errno 2] No such file or directory: '/mnt/larry/lilian/DATA/TCR3d_datasets/TCR_complexes_tfold_geochanged/4ei5.pdb'
3sdx.pdb	[Errno 2] No such file or directory: '/mnt/larry/lilian/DATA/TCR3d_datasets/TCR_complexes_tfold_geochanged/3sdx.pdb'
4wuu.pdb	[Errno 2] No such file or directory: '/mnt/larry/lilian/DATA/TCR3d_datasets/TCR_complexes_tfold_geochanged/4wuu.pdb'
6pug.pdb	[Errno 2] No such file or directory: '/mnt/larry/lilian/DATA/TCR3d_datasets/TCR_complexes_tfold_geochanged/6pug.pdb'
3to4.pdb	[Errno 2] No such file or directory: '/mnt/larry/lilian/DATA/TCR3d_datasets/TCR_complexes_tfold_geochanged/3to4.pdb'
7bh8.pdb	[Errno 2] No such file or directory: '/mnt/larry/lilian/DATA/TCR3d_datasets/TCR_complexes_tfold_geochanged/7bh8.pdb'
7bbg.pdb	[Errno 2] No such file or directory: '/mnt/larry/lilian/DATA/TCR3d_datasets/TCR_complexes_tfold_geochanged/7bbg.pdb'
5l2k.pdb	[Errno 2] No such file or directory: '/mnt/larry/lilian/DATA/TCR3d_datasets/TCR_complexes_tfold_geochanged/5l2k.pdb'
5xot.pdb	[Errno 2] No such file or directory: '/mnt/larry/lilian/DATA/TCR3d_datasets/TCR_complexes_tfold_geochanged/5xot.pdb'
6bj8.pdb	[Errno 2] No such file or directory: '/mnt/larry/lilian/DATA/TCR3d_datasets/TCR_complexes_tfold_geochanged/6bj8.pdb'
6pui.pdb	[Errno 2] No such file or directory: '/mnt/larry/lilian/DATA/TCR3d_datasets/TCR_complexes_tfold_geochanged/6pui.pdb'
5u16.pdb	[Errno 2] No such file or directory: '/mnt/larry/lilian/DATA/TCR3d_datasets/TCR_complexes_tfold_geochanged/5u16.pdb'
4en3.pdb	[Errno 2] No such file or directory: '/mnt/larry/lilian/DATA/TCR3d_datasets/TCR_complexes_tfold_geochanged/4en3.pdb'
7stf.pdb	[Errno 2] No such file or directory: '/mnt/larry/lilian/DATA/TCR3d_datasets/TCR_complexes_tfold_geochanged/7stf.pdb'
4elm.pdb	[Errno 2] No such file or directory: '/mnt/larry/lilian/DATA/TCR3d_datasets/TCR_complexes_tfold_geochanged/4elm.pdb'
4l9l.pdb	[Errno 2] No such file or directory: '/mnt/larry/lilian/DATA/TCR3d_datasets/TCR_complexes_tfold_geochanged/4l9l.pdb'
3gjf.pdb	[Errno 2] No such file or directory: '/mnt/larry/lilian/DATA/TCR3d_datasets/TCR_complexes_tfold_geochanged/3gjf.pdb'
5d7i.pdb	[Errno 2] No such file or directory: '/mnt/larry/lilian/DATA/TCR3d_datasets/TCR_complexes_tfold_geochanged/5d7i.pdb'
6puk.pdb	[Errno 2] No such file or directory: '/mnt/larry/lilian/DATA/TCR3d_datasets/TCR_complexes_tfold_geochanged/6puk.pdb'
4g8g.pdb	[Errno 2] No such file or directory: '/mnt/larry/lilian/DATA/TCR3d_datasets/TCR_complexes_tfold_geochanged/4g8g.pdb'
4x6c.pdb	[Errno 2] No such file or directory: '/mnt/larry/lilian/DATA/TCR3d_datasets/TCR_complexes_tfold_geochanged/4x6c.pdb'
3vwj.pdb	[Errno 2] No such file or directory: '/mnt/larry/lilian/DATA/TCR3d_datasets/TCR_complexes_tfold_geochanged/3vwj.pdb'
3he6.pdb	[Errno 2] No such file or directory: '/mnt/larry/lilian/DATA/TCR3d_datasets/TCR_complexes_tfold_geochanged/3he6.pdb'
3arg.pdb	[Errno 2] No such file or directory: '/mnt/larry/lilian/DATA/TCR3d_datasets/TCR_complexes_tfold_geochanged/3arg.pdb'
3qux.pdb	[Errno 2] No such file or directory: '/mnt/larry/lilian/DATA/TCR3d_datasets/TCR_complexes_tfold_geochanged/3qux.pdb'
3tn0.pdb	[Errno 2] No such file or directory: '/mnt/larry/lilian/DATA/TCR3d_datasets/TCR_complexes_tfold_geochanged/3tn0.pdb'
4pjh.pdb	[Errno 2] No such file or directory: '/mnt/larry/lilian/DATA/TCR3d_datasets/TCR_complexes_tfold_geochanged/4pjh.pdb'
3scm.pdb	[Errno 2] No such file or directory: '/mnt/larry/lilian/DATA/TCR3d_datasets/TCR_complexes_tfold_geochanged/3scm.pdb'
8yiv.pdb	[Errno 2] No such file or directory: '/mnt/larry/lilian/DATA/TCR3d_datasets/TCR_complexes_tfold_geochanged/8yiv.pdb'
8gon.pdb	[Errno 2] No such file or directory: '/mnt/larry/lilian/DATA/TCR3d_datasets/TCR_complexes_tfold_geochanged/8gon.pdb'
6bj3.pdb	[Errno 2] No such file or directory: '/mnt/larry/lilian/DATA/TCR3d_datasets/TCR_complexes_tfold_geochanged/6bj3.pdb'
4pja.pdb	[Errno 2] No such file or directory: '/mnt/larry/lilian/DATA/TCR3d_datasets/TCR_complexes_tfold_geochanged/4pja.pdb'
4wwk.pdb	[Errno 2] No such file or directory: '/mnt/larry/lilian/DATA/TCR3d_datasets/TCR_complexes_tfold_geochanged/4wwk.pdb'
1fo0.pdb	[Errno 2] No such file or directory: '/mnt/larry/lilian/DATA/TCR3d_datasets/TCR_complexes_tfold_geochanged/1fo0.pdb'
1ypz.pdb	[Errno 2] No such file or directory: '/mnt/larry/lilian/DATA/TCR3d_datasets/TCR_complexes_tfold_geochanged/1ypz.pdb'
3sdc.pdb	[Errno 2] No such file or directory: '/mnt/larry/lilian/DATA/TCR3d_datasets/TCR_complexes_tfold_geochanged/3sdc.pdb'
7ufj.pdb	[Errno 2] No such file or directory: '/mnt/larry/lilian/DATA/TCR3d_datasets/TCR_complexes_tfold_geochanged/7ufj.pdb'
2po6.pdb	[Errno 2] No such file or directory: '/mnt/larry/lilian/DATA/TCR3d_datasets/TCR_complexes_tfold_geochanged/2po6.pdb'
5xov.pdb	[Errno 2] No such file or directory: '/mnt/larry/lilian/DATA/TCR3d_datasets/TCR_complexes_tfold_geochanged/5xov.pdb'
6vrn.pdb	[Errno 2] No such file or directory: '/mnt/larry/lilian/DATA/TCR3d_datasets/TCR_complexes_tfold_geochanged/6vrn.pdb'
4y4h.pdb	[Errno 2] No such file or directory: '/mnt/larry/lilian/DATA/TCR3d_datasets/TCR_complexes_tfold_geochanged/4y4h.pdb'
3ard.pdb	[Errno 2] No such file or directory: '/mnt/larry/lilian/DATA/TCR3d_datasets/TCR_complexes_tfold_geochanged/3ard.pdb'
7ryn.pdb	[Errno 2] No such file or directory: '/mnt/larry/lilian/DATA/TCR3d_datasets/TCR_complexes_tfold_geochanged/7ryn.pdb'
4pjc.pdb	[Errno 2] No such file or directory: '/mnt/larry/lilian/DATA/TCR3d_datasets/TCR_complexes_tfold_geochanged/4pjc.pdb'
4irj.pdb	[Errno 2] No such file or directory: '/mnt/larry/lilian/DATA/TCR3d_datasets/TCR_complexes_tfold_geochanged/4irj.pdb'
7zt4.pdb	[Errno 2] No such file or directory: '/mnt/larry/lilian/DATA/TCR3d_datasets/TCR_complexes_tfold_geochanged/7zt4.pdb'
4zak.pdb	[Errno 2] No such file or directory: '/mnt/larry/lilian/DATA/TCR3d_datasets/TCR_complexes_tfold_geochanged/4zak.pdb'
8es8.pdb	[Errno 2] No such file or directory: '/mnt/larry/lilian/DATA/TCR3d_datasets/TCR_complexes_tfold_geochanged/8es8.pdb'
7zt8.pdb	[Errno 2] No such file or directory: '/mnt/larry/lilian/DATA/TCR3d_datasets/TCR_complexes_tfold_geochanged/7zt8.pdb'
4pjx.pdb	[Errno 2] No such file or directory: '/mnt/larry/lilian/DATA/TCR3d_datasets/TCR_complexes_tfold_geochanged/4pjx.pdb'
7llj.pdb	[Errno 2] No such file or directory: '/mnt/larry/lilian/DATA/TCR3d_datasets/TCR_complexes_tfold_geochanged/7llj.pdb'
5d7j.pdb	[Errno 2] No such file or directory: '/mnt/larry/lilian/DATA/TCR3d_datasets/TCR_complexes_tfold_geochanged/5d7j.pdb'
6p64.pdb	[Errno 2] No such file or directory: '/mnt/larry/lilian/DATA/TCR3d_datasets/TCR_complexes_tfold_geochanged/6p64.pdb'
4pj5.pdb	[Errno 2] No such file or directory: '/mnt/larry/lilian/DATA/TCR3d_datasets/TCR_complexes_tfold_geochanged/4pj5.pdb'
3are.pdb	[Errno 2] No such file or directory: '/mnt/larry/lilian/DATA/TCR3d_datasets/TCR_complexes_tfold_geochanged/3are.pdb'
3tzv.pdb	[Errno 2] No such file or directory: '/mnt/larry/lilian/DATA/TCR3d_datasets/TCR_complexes_tfold_geochanged/3tzv.pdb'
3rug.pdb	[Errno 2] No such file or directory: '/mnt/larry/lilian/DATA/TCR3d_datasets/TCR_complexes_tfold_geochanged/3rug.pdb'
4y2d.pdb	[Errno 2] No such file or directory: '/mnt/larry/lilian/DATA/TCR3d_datasets/TCR_complexes_tfold_geochanged/4y2d.pdb'
3hae.pdb	[Errno 2] No such file or directory: '/mnt/larry/lilian/DATA/TCR3d_datasets/TCR_complexes_tfold_geochanged/3hae.pdb'
6puc.pdb	[Errno 2] No such file or directory: '/mnt/larry/lilian/DATA/TCR3d_datasets/TCR_complexes_tfold_geochanged/6puc.pdb'
5wki.pdb	[Errno 2] No such file or directory: '/mnt/larry/lilian/DATA/TCR3d_datasets/TCR_complexes_tfold_geochanged/5wki.pdb'
7zt9.pdb	[Errno 2] No such file or directory: '/mnt/larry/lilian/DATA/TCR3d_datasets/TCR_complexes_tfold_geochanged/7zt9.pdb'
4pje.pdb	[Errno 2] No such file or directory: '/mnt/larry/lilian/DATA/TCR3d_datasets/TCR_complexes_tfold_geochanged/4pje.pdb'
6pvd.pdb	[Errno 2] No such file or directory: '/mnt/larry/lilian/DATA/TCR3d_datasets/TCR_complexes_tfold_geochanged/6pvd.pdb'
5u72.pdb	[Errno 2] No such file or directory: '/mnt/larry/lilian/DATA/TCR3d_datasets/TCR_complexes_tfold_geochanged/5u72.pdb'
4apq.pdb	[Errno 2] No such file or directory: '/mnt/larry/lilian/DATA/TCR3d_datasets/TCR_complexes_tfold_geochanged/4apq.pdb'
6w51.pdb	[Errno 2] No such file or directory: '/mnt/larry/lilian/DATA/TCR3d_datasets/TCR_complexes_tfold_geochanged/6w51.pdb'
7zt2.pdb	[Errno 2] No such file or directory: '/mnt/larry/lilian/DATA/TCR3d_datasets/TCR_complexes_tfold_geochanged/7zt2.pdb'
6pum.pdb	[Errno 2] No such file or directory: '/mnt/larry/lilian/DATA/TCR3d_datasets/TCR_complexes_tfold_geochanged/6pum.pdb'
5vcj.pdb	[Errno 2] No such file or directory: '/mnt/larry/lilian/DATA/TCR3d_datasets/TCR_complexes_tfold_geochanged/5vcj.pdb'
6pud.pdb	[Errno 2] No such file or directory: '/mnt/larry/lilian/DATA/TCR3d_datasets/TCR_complexes_tfold_geochanged/6pud.pdb'
6bnk.pdb	[Errno 2] No such file or directory: '/mnt/larry/lilian/DATA/TCR3d_datasets/TCR_complexes_tfold_geochanged/6bnk.pdb'
6puj.pdb	[Errno 2] No such file or directory: '/mnt/larry/lilian/DATA/TCR3d_datasets/TCR_complexes_tfold_geochanged/6puj.pdb'
9bys.pdb	[Errno 2] No such file or directory: '/mnt/larry/lilian/DATA/TCR3d_datasets/TCR_complexes_tfold_geochanged/9bys.pdb'
4l8s.pdb	[Errno 2] No such file or directory: '/mnt/larry/lilian/DATA/TCR3d_datasets/TCR_complexes_tfold_geochanged/4l8s.pdb'
6uj9.pdb	[Errno 2] No such file or directory: '/mnt/larry/lilian/DATA/TCR3d_datasets/TCR_complexes_tfold_geochanged/6uj9.pdb'
3ta3.pdb	[Errno 2] No such file or directory: '/mnt/larry/lilian/DATA/TCR3d_datasets/TCR_complexes_tfold_geochanged/3ta3.pdb'
9c9d.pdb	[Errno 2] No such file or directory: '/mnt/larry/lilian/DATA/TCR3d_datasets/TCR_complexes_tfold_geochanged/9c9d.pdb'
5jzi.pdb	[Errno 2] No such file or directory: '/mnt/larry/lilian/DATA/TCR3d_datasets/TCR_complexes_tfold_geochanged/5jzi.pdb'
7rym.pdb	[Errno 2] No such file or directory: '/mnt/larry/lilian/DATA/TCR3d_datasets/TCR_complexes_tfold_geochanged/7rym.pdb'
1w72.pdb	[Errno 2] No such file or directory: '/mnt/larry/lilian/DATA/TCR3d_datasets/TCR_complexes_tfold_geochanged/1w72.pdb'
3quz.pdb	[Errno 2] No such file or directory: '/mnt/larry/lilian/DATA/TCR3d_datasets/TCR_complexes_tfold_geochanged/3quz.pdb'
3quy.pdb	[Errno 2] No such file or directory: '/mnt/larry/lilian/DATA/TCR3d_datasets/TCR_complexes_tfold_geochanged/3quy.pdb'
8yj2.pdb	[Errno 2] No such file or directory: '/mnt/larry/lilian/DATA/TCR3d_datasets/TCR_complexes_tfold_geochanged/8yj2.pdb'
